180 180 180 180 180 180 180 180 180 180 180 180 180 180 180 180 180 180 180 180 180 180 180 180 180 180 180 180 180 180 180 180 180 180 180 180 180 180 180 180 180 180 180 180 180 180 180 180 180 180 
180 180 180 180 180 180 180 180 180 180 180 180 180 180 180 180 180 180 180 180 180 180 180 180 180 180 180 180 180 180 180 180 180 180 180 180 180 180 180 180 180 180 180 180 180 180 180 180 180 180 
180 180 180 180 180 180 180 180 180 180 180 180 180 180 180 180 180 180 180 180 180 180 180 180 180 180 180 180 180 180 180 180 180 180 180 180 180 180 180 180 180 180 180 180 180 180 180 180 180 180 
180 180 180 180 180 180 180 180 180 180 180 180 180 180 180 180 180 180 180 180 180 180 180 180 180 180 180 180 180 180 180 180 180 180 180 180 180 180 180 180 180 180 180 180 180 180 180 180 180 180 
180 180 180 180 180 180 180 180 180 180 180 180 180 180 180 180 180 180 180 180 180 180 180 180 180 180 180 180 180 180 180 180 180 180 180 180 180 180 180 180 180 180 180 180 180 180 180 180 180 180 
180 180 180 180 180 180 180 180 180 180 180 180 180 180 180 180 180 180 180 180 180 180 180 180 180 180 180 180 180 180 180 180 180 180 180 180 180 180 180 180 180 180 180 180 180 180 180 180 180 180 
180 180 180 180 180 180 180 180 180 180 180 180 180 180 180 180 180 180 180 180 180 180 180 180 180 180 180 180 180 180 180 180 180 180 180 180 180 180 180 180 180 180 180 180 180 180 180 180 180 180 
180 180 180 180 180 180 180 180 180 184 183 183 183 183 183 183 183 183 183 184 183 183 183 183 183 183 183 184 184 183 183 183 183 183 183 183 183 183 183 183 183 180 180 180 180 180 180 180 180 180 
180 180 180 180 180 180 180 180 180 184 183 228 183 183 183 184 183 183 183 183 183 184 184 183 184 184 183 184 183 183 183 183 183 183 228 228 183 183 183 183 183 180 180 180 180 180 180 180 180 180 
180 180 180 180 180 180 180 180 180 183 183 184 183 183 183 183 183 183 183 183 183 184 183 228 228 228 228 228 183 183 183 183 183 183 184 184 184 183 183 183 183 180 180 180 180 180 180 180 180 180 
180 180 180 180 180 180 180 180 180 183 183 184 183 183 183 183 183 228 228 228 184 184 228 183 183 183 183 183 184 228 184 228 228 183 228 228 184 228 183 184 184 180 180 180 180 180 180 180 180 180 
180 180 180 180 180 180 180 180 180 183 183 184 183 183 183 228 228 184 183 183 228 184 183 183 183 184 183 228 228 228 183 183 183 228 228 228 183 228 183 183 183 180 180 180 180 180 180 180 180 180 
180 180 180 180 180 180 180 180 180 183 183 228 228 228 228 183 183 183 183 183 228 183 184 184 184 184 183 228 228 228 184 184 184 184 184 184 228 183 183 183 183 180 180 180 180 180 180 180 180 180 
180 180 180 180 180 180 180 180 180 183 183 184 183 228 183 183 183 184 183 183 228 183 183 228 183 183 183 183 183 228 184 228 183 228 183 183 184 183 183 183 183 180 180 180 180 180 180 180 180 180 
180 180 180 180 180 180 180 180 180 183 228 183 183 228 183 184 228 183 183 228 228 228 228 183 183 183 183 183 183 184 228 228 228 183 183 183 183 228 184 183 183 180 180 180 180 180 180 180 180 180 
180 180 180 180 180 180 180 180 180 228 228 183 183 228 184 184 183 183 183 228 183 228 183 228 184 183 183 183 183 183 183 228 228 183 228 183 183 183 183 183 183 180 180 180 180 180 180 180 180 180 
180 180 180 180 180 180 180 180 180 184 183 183 183 183 183 184 183 183 183 228 184 228 183 183 228 184 228 184 183 228 184 183 228 184 183 184 228 183 183 183 183 180 180 180 180 180 180 180 180 180 
180 180 180 180 180 180 180 180 180 183 228 183 228 183 183 184 183 183 228 228 183 184 228 228 228 184 183 228 228 183 183 183 183 183 183 228 183 184 183 183 184 180 180 180 180 180 180 180 180 180 
180 180 180 180 180 180 180 180 180 183 228 228 183 228 183 184 184 228 183 183 183 183 183 183 184 184 228 228 183 183 183 228 183 228 183 228 183 183 183 184 183 180 180 180 180 180 180 180 180 180 
180 180 180 180 180 180 180 180 180 183 183 228 183 228 183 183 184 184 183 228 228 183 184 183 184 228 228 184 228 183 183 183 183 184 183 183 183 183 183 184 184 180 180 180 180 180 180 180 180 180 
180 180 180 180 180 180 180 180 180 228 184 184 183 228 183 183 183 184 183 183 183 183 183 228 184 228 183 183 228 228 228 228 183 184 183 183 183 183 183 183 184 180 180 180 180 180 180 180 180 180 
180 180 180 180 180 180 180 180 180 228 183 183 183 183 228 228 228 184 183 184 228 183 228 183 228 228 228 183 228 228 183 183 183 184 183 183 184 183 184 184 184 180 180 180 180 180 180 180 180 180 
180 180 180 180 180 180 180 180 180 228 228 183 184 228 183 183 183 183 184 184 228 228 228 184 184 228 228 183 184 184 228 184 184 184 183 184 183 183 183 183 183 180 180 180 180 180 180 180 180 180 
180 180 180 180 180 180 180 180 180 183 228 228 184 228 228 183 184 184 228 183 184 228 184 228 184 184 183 184 184 183 183 183 183 228 228 184 183 183 183 183 183 180 180 180 180 180 180 180 180 180 
180 180 180 180 180 180 180 180 180 183 183 184 228 184 184 184 228 228 183 183 183 184 184 183 183 183 184 184 183 183 183 183 183 183 183 183 184 183 183 183 183 180 180 180 180 180 180 180 180 180 
180 180 180 180 180 180 180 180 180 180 180 180 180 180 180 180 180 180 180 180 180 180 180 180 180 183 183 180 180 180 180 180 180 180 180 180 180 180 180 180 180 180 180 180 180 180 180 180 180 180 
180 180 180 180 180 180 180 180 180 180 180 180 180 180 180 180 180 180 180 180 180 180 180 180 180 183 183 180 180 180 180 180 180 180 180 180 180 180 180 180 180 180 180 180 180 180 180 180 180 180 
180 180 180 180 180 180 180 180 180 180 180 180 180 180 180 180 180 180 180 180 180 180 180 180 180 183 183 180 180 180 180 180 180 180 180 180 180 180 180 180 180 180 180 180 180 180 180 180 180 180 
180 180 180 180 180 180 180 180 180 180 180 180 180 180 180 180 180 180 180 180 180 180 180 180 180 183 183 180 180 180 180 180 180 180 180 180 180 180 180 180 180 180 180 180 180 180 180 180 180 180 
180 180 180 180 180 180 180 180 180 180 180 180 180 180 180 180 180 180 180 180 180 180 180 180 180 183 183 180 180 180 180 180 180 180 180 180 180 180 180 180 180 180 180 180 180 180 180 180 180 180 
180 180 180 180 180 180 180 180 180 180 180 180 180 180 180 180 180 180 180 180 180 180 180 180 180 183 183 180 180 180 180 180 180 180 180 180 180 180 180 180 180 180 180 180 180 180 180 180 180 180 
180 180 180 180 180 180 180 180 180 180 180 180 180 180 180 180 180 180 180 180 180 180 180 180 180 183 183 180 180 180 180 180 180 180 180 180 180 180 180 180 180 180 180 180 180 180 180 180 180 180 
180 180 180 180 180 180 180 180 180 180 180 180 180 180 180 180 180 180 180 180 180 180 180 180 183 183 183 183 180 180 180 180 180 180 180 180 180 180 180 180 180 180 180 180 180 180 180 180 180 180 
180 180 180 180 180 180 180 180 180 180 180 180 180 180 180 180 180 180 180 180 180 180 180 183 183 183 183 183 183 180 180 180 180 180 180 180 180 180 180 180 180 180 180 180 180 180 180 180 180 180 
180 180 180 180 180 180 180 180 180 180 180 180 180 180 180 180 180 180 180 180 180 180 180 183 183 183 183 183 183 180 180 180 180 180 180 180 180 180 180 180 180 180 180 180 180 180 180 180 180 180 
180 180 180 180 180 180 180 180 180 180 180 180 180 180 180 180 180 180 180 180 180 180 180 180 180 180 180 180 180 180 180 180 180 180 180 180 180 180 180 180 180 180 180 180 180 180 180 180 180 180 
180 180 180 180 180 180 180 180 180 180 180 180 180 180 180 180 180 180 180 180 180 180 180 180 180 180 180 180 180 180 180 180 180 180 180 180 180 180 180 180 180 180 180 180 180 180 180 180 180 180 
180 180 180 180 180 180 180 180 180 180 180 180 180 180 180 180 180 180 180 180 180 180 180 180 180 180 180 180 180 180 180 180 180 180 180 180 180 180 180 180 180 180 180 180 180 180 180 180 180 180 
180 180 180 180 180 180 180 180 180 180 180 180 180 180 180 180 180 180 180 180 180 180 180 180 180 180 180 180 180 180 180 180 180 180 180 180 180 180 180 180 180 180 180 180 180 180 180 180 180 180 
180 180 180 180 180 180 180 180 180 180 180 180 180 180 180 180 180 180 180 180 180 180 180 180 180 180 180 180 180 180 180 180 180 180 180 180 180 180 180 180 180 180 180 180 180 180 180 180 180 180 
180 180 180 180 180 180 180 180 180 180 180 180 180 180 180 180 180 180 180 180 180 180 180 180 180 180 180 180 180 180 180 180 180 180 180 180 180 180 180 180 180 180 180 180 180 180 180 180 180 180 
180 180 180 180 180 180 180 180 180 180 180 180 180 180 180 180 180 180 180 180 180 180 180 180 180 180 180 180 180 180 180 180 180 180 180 180 180 180 180 180 180 180 180 180 180 180 180 180 180 180 
180 180 180 180 180 180 180 180 180 180 180 180 180 180 180 180 180 180 180 180 180 180 180 180 180 180 180 180 180 180 180 180 180 180 180 180 180 180 180 180 180 180 180 180 180 180 180 180 180 180 
180 180 180 180 180 180 180 180 180 180 180 180 180 180 180 180 180 180 180 180 180 180 180 180 180 180 180 180 180 180 180 180 180 180 180 180 180 180 180 180 180 180 180 180 180 180 180 180 180 180 
180 180 180 180 180 180 180 180 180 180 180 180 180 180 180 180 180 180 180 180 180 180 180 180 180 180 180 180 180 180 180 180 180 180 180 180 180 180 180 180 180 180 180 180 180 180 180 180 180 180 
180 180 180 180 180 180 180 180 180 180 180 180 180 180 180 180 180 180 180 180 180 180 180 180 180 180 180 180 180 180 180 180 180 180 180 180 180 180 180 180 180 180 180 180 180 180 180 180 180 180 
180 180 180 180 180 180 180 180 180 180 180 180 180 180 180 180 180 180 180 180 180 180 180 180 180 180 180 180 180 180 180 180 180 180 180 180 180 180 180 180 180 180 180 180 180 180 180 180 180 180 
180 180 180 180 180 180 180 180 180 180 180 180 180 180 180 180 180 180 180 180 180 180 180 180 180 180 180 180 180 180 180 180 180 180 180 180 180 180 180 180 180 180 180 180 180 180 180 180 180 180 
180 180 180 180 180 180 180 180 180 180 180 180 180 180 180 180 180 180 180 180 180 180 180 180 180 180 180 180 180 180 180 180 180 180 180 180 180 180 180 180 180 180 180 180 180 180 180 180 180 180 
180 180 180 180 180 180 180 180 180 180 180 180 180 180 180 180 180 180 180 180 180 180 180 180 180 180 180 180 180 180 180 180 180 180 180 180 180 180 180 180 180 180 180 180 180 180 180 180 180 180
