19 18 19 18 19 19 19 19 19 19 19 19 19 19 19 19 19 19 19 19 19 19 19 19 19 19 19 19 19 19 19 19 19 19 19 19 19 19 19 19 19 19 19 19 19 19 19 19 19 19 
19 19 28 26 26 26 26 26 26 26 26 26 26 26 26 26 26 26 26 26 26 26 26 26 26 26 26 26 26 29 19 19 19 19 19 19 19 19 19 19 19 19 19 19 19 19 19 19 19 19 
18 19 24 3 3 3 3 3 7 16 16 16 16 16 16 16 16 16 16 16 16 16 16 16 16 16 16 16 16 23 19 19 19 19 19 19 19 19 19 19 19 19 19 19 19 19 19 19 19 19 
18 18 24 3 3 3 3 3 7 16 16 16 16 16 16 16 16 16 16 16 16 16 16 16 16 1 1 1 16 23 19 19 19 19 19 19 19 19 19 19 19 19 19 19 19 19 19 19 19 19 
19 18 24 3 3 36 3 3 7 16 16 16 16 16 16 16 16 16 16 16 16 16 16 16 16 1 1 1 16 23 19 19 19 19 19 19 19 19 19 19 19 19 19 19 19 19 19 19 19 19 
18 18 24 3 3 3 3 3 7 2 2 2 2 2 2 2 2 2 2 2 2 2 2 2 1 1 1 1 16 25 26 26 26 26 26 26 26 26 26 26 26 29 19 19 19 19 19 19 19 19 
19 19 24 3 3 3 3 3 7 16 16 16 16 2 16 16 16 16 16 16 16 16 16 16 16 16 16 16 16 16 16 16 16 16 16 16 16 16 16 16 16 23 19 19 19 19 19 19 19 19 
19 18 24 5 5 5 5 5 15 16 16 16 16 2 16 16 16 16 16 16 16 16 16 16 16 16 16 16 16 16 16 16 16 16 16 16 16 16 16 16 16 23 19 19 19 19 19 19 19 19 
19 19 24 16 16 16 16 16 16 16 16 16 16 2 16 16 16 16 16 16 16 16 16 16 2 2 2 2 2 2 2 2 16 2 2 2 2 2 2 16 16 23 19 19 19 19 19 19 19 19 
19 19 24 16 2 16 16 16 16 16 2 2 16 2 16 16 16 16 16 16 16 16 16 16 2 2 2 2 2 2 2 2 2 2 2 2 2 16 2 16 16 25 26 26 26 26 26 26 26 29 
19 19 24 16 2 2 2 2 2 2 2 16 16 2 2 2 16 16 16 16 16 16 16 16 2 2 2 2 16 2 2 2 2 2 2 2 2 2 2 16 16 16 16 16 16 16 16 16 16 23 
19 19 24 16 2 16 16 16 16 16 16 16 16 2 16 2 16 16 12 10 10 10 10 10 10 10 10 10 10 10 10 10 10 10 2 16 2 2 2 16 16 16 16 16 16 16 16 16 16 23 
19 19 24 16 2 16 16 16 3 3 3 16 16 2 16 2 16 16 8 34 34 34 34 34 34 34 34 34 34 34 34 34 34 34 7 2 2 2 2 2 16 12 10 10 10 10 10 10 13 23 
19 19 24 16 2 16 3 3 3 3 3 3 3 2 16 2 2 16 8 34 4 5 5 5 5 5 5 5 5 5 5 5 6 34 7 2 2 2 2 2 16 8 34 34 34 34 34 34 7 23 
19 19 24 16 2 16 3 3 3 3 3 3 3 16 16 2 16 16 8 34 7 2 2 2 2 2 2 2 2 2 2 2 8 34 7 16 2 2 2 2 16 8 34 34 34 34 34 34 7 23 
19 19 24 16 2 16 3 3 3 3 3 3 3 16 16 2 16 16 8 34 7 20 21 21 21 21 21 21 21 21 21 22 8 34 7 2 2 2 2 2 16 8 34 34 34 34 34 34 7 23 
19 19 24 16 2 16 3 3 3 3 3 3 3 16 16 2 16 16 8 34 7 23 18 28 26 26 26 29 18 18 18 24 8 34 7 2 2 2 16 2 16 8 34 34 34 34 34 34 7 23 
19 19 24 16 2 16 16 16 3 3 3 3 16 16 16 2 2 16 8 34 7 23 18 24 16 2 16 25 26 29 18 24 8 34 9 10 10 10 10 10 10 11 34 34 34 34 34 34 7 23 
19 19 24 16 2 2 16 16 16 16 2 16 16 2 16 16 2 16 8 34 7 23 18 30 22 2 2 2 16 23 18 24 8 34 34 34 34 34 34 34 34 34 34 34 34 34 34 34 7 23 
19 19 24 16 16 2 16 16 16 16 2 16 2 2 16 16 2 16 8 34 7 25 29 18 30 22 2 16 2 25 29 24 8 34 4 5 5 5 5 5 5 6 34 34 34 34 34 34 7 23 
19 19 24 16 16 2 2 2 2 2 2 16 16 16 16 2 2 16 8 34 7 2 25 29 18 30 22 2 2 16 23 24 8 34 7 16 16 16 16 16 16 8 34 34 34 34 34 34 7 23 
19 19 24 16 16 16 16 16 16 16 2 2 2 2 16 16 16 16 8 34 7 2 2 25 26 29 30 22 16 2 23 24 8 34 7 2 2 2 2 16 16 8 34 34 34 34 34 34 7 23 
19 19 24 2 2 2 2 2 2 16 16 16 16 2 16 16 16 16 8 34 7 2 2 2 2 23 18 30 21 21 31 24 8 34 7 16 16 16 2 16 16 8 34 34 34 34 34 34 7 23 
19 19 24 2 16 16 16 16 2 16 16 16 16 2 16 2 2 16 8 34 7 2 2 2 2 23 18 18 18 18 18 24 8 34 7 16 16 16 2 16 16 8 34 34 34 34 34 34 7 23 
19 19 24 2 16 16 3 3 3 3 16 16 16 2 16 16 2 16 8 34 7 2 2 2 2 25 26 26 26 26 26 27 8 34 7 16 16 16 16 16 16 8 34 34 34 34 34 34 7 23 
19 19 24 2 16 3 3 3 3 3 7 2 2 2 16 16 2 16 8 34 9 10 10 10 10 10 10 10 10 10 10 10 11 34 7 2 2 16 16 16 16 8 34 34 34 34 34 34 7 23 
19 19 24 2 16 3 3 3 3 3 16 16 16 2 2 2 2 16 8 34 34 34 34 34 34 34 34 34 34 34 34 34 34 34 7 16 16 16 16 16 16 8 34 34 34 34 34 34 7 23 
19 19 24 2 16 3 3 3 3 3 16 16 16 2 16 16 16 16 14 5 5 5 5 5 5 5 5 5 5 5 5 5 5 5 15 2 2 2 2 16 16 14 5 5 5 5 5 5 15 23 
19 19 24 2 16 16 16 16 16 16 16 16 16 2 16 16 16 16 16 16 16 16 16 16 16 16 16 16 16 16 16 16 2 16 16 16 16 16 2 16 16 20 21 21 21 21 21 21 21 31 
19 19 24 2 2 2 2 2 2 16 16 16 16 2 2 2 2 2 2 2 2 16 16 16 16 16 16 16 2 2 2 16 2 16 16 16 16 16 2 16 16 23 19 19 19 19 19 19 19 19 
19 19 24 16 16 16 16 16 16 16 16 2 16 16 16 16 16 16 16 16 2 2 2 2 2 2 2 2 2 16 2 16 2 16 2 2 2 2 2 16 16 23 19 19 19 19 19 19 19 19 
19 19 30 21 21 21 21 21 22 16 16 2 2 2 16 16 16 16 16 16 16 16 16 16 16 16 16 16 16 2 2 16 2 16 2 16 16 16 16 16 16 23 19 19 19 19 19 19 19 19 
19 19 19 19 19 19 19 19 24 16 16 2 33 2 16 16 16 2 2 2 2 2 2 2 16 16 16 16 16 16 2 16 2 16 2 16 16 16 16 16 16 23 19 19 19 19 19 19 19 19 
19 19 19 19 19 19 19 19 24 16 16 2 2 2 16 16 16 2 16 16 16 2 2 2 16 16 16 16 16 16 2 16 2 16 2 2 16 16 16 16 16 23 19 19 19 19 19 19 19 19 
19 19 19 19 19 19 19 19 24 16 16 2 2 2 16 16 16 2 16 16 16 2 16 16 16 16 16 16 16 16 2 16 2 16 16 2 16 16 16 16 16 23 19 19 19 19 19 19 19 19 
19 19 19 19 19 19 19 19 24 2 2 2 16 16 16 16 16 2 16 16 16 2 10 16 10 10 16 16 16 16 2 16 2 16 16 2 2 2 2 2 16 23 19 19 19 19 19 19 19 19 
19 19 19 19 19 19 19 19 24 2 16 16 16 16 16 16 16 2 2 2 16 16 3 3 3 3 7 2 2 2 2 16 2 11 3 16 16 16 16 2 16 23 19 19 19 19 19 19 19 19 
19 19 19 19 19 19 19 19 24 2 16 2 2 2 2 16 16 2 16 2 16 3 3 3 3 3 16 16 16 16 16 16 16 3 3 3 16 16 2 2 16 23 19 19 19 19 19 19 19 19 
19 19 19 19 19 19 19 19 24 2 16 2 16 16 2 16 16 16 16 2 16 3 3 3 3 3 3 16 2 2 2 2 16 3 3 3 3 16 2 16 16 23 19 19 19 19 19 19 19 19 
19 19 19 19 19 19 19 19 24 2 16 2 16 16 2 16 16 2 16 2 16 3 3 3 3 3 3 16 2 16 16 2 16 16 3 3 16 16 10 16 16 23 19 19 19 19 19 19 19 19 
19 19 19 19 19 19 19 19 24 2 16 2 16 2 2 16 16 2 2 2 16 16 3 3 3 3 16 16 2 16 16 16 16 16 16 16 16 16 3 16 16 23 19 19 19 19 19 19 19 19 
19 19 19 19 19 19 19 19 24 2 16 2 16 2 16 16 16 2 16 16 16 16 16 16 16 5 16 16 2 2 2 2 2 2 2 8 3 3 3 3 16 23 19 19 19 19 19 19 19 19 
19 19 19 19 19 19 19 19 24 2 2 2 16 2 16 16 2 2 2 2 2 2 2 16 16 2 16 16 16 16 16 16 16 16 16 8 3 3 3 3 16 23 19 19 19 19 19 19 19 19 
19 19 19 19 19 19 19 19 24 16 16 16 16 2 2 2 2 16 16 16 16 16 2 16 16 2 2 2 2 2 2 2 2 2 2 8 3 3 3 16 16 23 19 19 19 19 19 19 19 19 
19 19 19 19 19 19 19 19 24 16 16 16 16 16 16 16 16 16 16 16 16 16 16 16 16 16 16 16 16 16 16 16 16 16 16 16 16 16 16 16 16 23 19 19 19 19 19 19 19 19 
19 19 19 19 19 19 19 19 30 21 21 21 21 21 21 21 21 21 21 21 21 21 21 21 21 21 21 21 21 21 21 21 21 21 21 21 21 21 21 21 21 31 19 19 19 19 19 19 19 19 
19 19 19 19 19 19 19 19 19 19 19 19 19 19 19 19 19 19 19 19 19 19 19 19 19 19 19 19 19 19 19 19 19 19 19 19 19 19 19 19 19 19 19 19 19 19 19 19 19 19 
19 19 19 19 19 19 19 19 19 19 19 19 19 19 19 19 19 19 19 19 19 19 19 19 19 19 19 19 19 19 19 19 19 19 19 19 19 19 19 19 19 19 19 19 19 19 19 19 19 19 
19 19 19 19 19 19 19 19 19 19 19 19 19 19 19 19 19 19 19 19 19 19 19 19 19 19 19 19 19 19 19 19 19 19 19 19 19 19 19 19 19 19 19 19 19 19 19 19 19 19 
19 19 19 19 19 19 19 19 19 19 19 19 19 19 19 19 19 19 19 19 19 19 19 19 19 19 19 19 19 19 19 19 19 19 19 19 19 19 19 19 19 19 19 19 19 19 19 19 19 19 
