162 162 162 162 162 162 162 162 162 162 162 162 162 162 162 162 162 162 162 162 162 162 162 162 162 162 162 162 162 162 162 162 162 162 162 162 162 162 162 162 162 162 162 162 162 162 162 162 162 162 
162 162 162 162 162 162 162 162 162 162 162 162 162 162 162 162 162 162 162 162 162 162 162 162 162 162 162 162 162 162 162 162 162 162 162 162 162 162 162 162 162 162 162 162 162 162 162 162 162 162 
162 162 162 162 162 162 162 162 162 162 162 162 162 162 162 162 162 162 162 162 162 132 132 132 132 132 132 132 132 162 162 162 162 162 162 162 162 162 162 162 162 162 162 162 162 162 162 162 162 162 
162 162 162 162 162 162 162 162 162 162 162 162 162 162 162 162 162 162 162 162 162 132 132 132 135 136 132 132 132 162 162 162 162 162 162 162 162 162 162 162 162 162 162 162 162 162 162 162 162 162 
162 162 162 162 162 162 162 162 162 162 162 162 162 162 162 162 162 162 162 162 162 132 132 132 137 138 132 132 132 162 162 162 162 162 162 162 162 162 162 162 162 162 162 162 162 162 162 162 162 162 
162 162 162 162 162 162 162 162 162 162 162 162 162 162 162 162 162 162 162 162 162 132 132 160 134 141 160 132 132 162 162 162 162 162 162 162 162 162 162 162 162 162 162 162 162 162 162 162 162 162 
162 162 162 162 162 162 162 162 162 162 162 162 162 162 162 162 162 162 162 162 162 132 132 132 134 134 132 132 132 162 162 162 162 162 162 162 162 162 162 162 162 162 162 162 162 162 162 162 162 162 
162 162 162 162 162 162 162 162 162 162 162 162 162 162 162 162 162 162 162 162 162 162 162 132 134 134 132 162 162 162 162 162 162 162 162 162 162 162 162 162 162 162 162 162 162 162 162 162 162 162 
162 162 162 162 162 162 162 162 162 162 162 162 162 162 162 162 162 162 162 162 162 162 162 132 134 134 132 162 162 162 162 162 162 162 162 162 162 162 162 162 162 162 162 162 162 162 162 162 162 162 
162 162 132 132 132 132 132 132 132 132 132 132 132 132 162 162 162 162 162 162 162 162 162 132 141 134 132 162 162 162 162 162 162 162 162 162 162 162 162 162 162 162 162 162 162 162 162 162 162 162 
162 162 132 037 134 134 134 134 134 134 134 134 134 132 162 162 162 162 162 162 162 162 162 132 134 134 132 162 162 162 162 162 162 162 162 132 132 132 132 132 132 132 132 132 132 132 132 132 162 162 
162 162 132 160 134 134 134 134 134 134 134 134 160 132 162 162 162 162 132 132 132 132 132 132 134 134 132 132 132 132 132 132 162 162 162 132 134 134 134 134 134 134 134 134 134 134 134 132 162 162 
162 162 132 134 134 134 134 134 159 159 159 134 134 132 162 162 162 162 132 134 134 134 134 134 134 141 134 134 134 134 141 132 162 162 162 132 134 134 134 134 134 134 134 134 134 134 134 132 162 162 
162 162 132 134 134 134 134 134 134 134 159 134 134 132 132 132 132 132 132 134 134 134 134 134 134 134 134 134 134 134 160 132 132 132 132 132 160 141 134 134 134 159 134 159 134 134 134 132 162 162 
162 162 132 134 134 134 134 134 134 134 159 134 134 134 134 134 134 134 134 134 134 159 159 159 159 134 134 134 134 134 134 134 134 134 134 134 134 134 134 134 134 134 134 134 134 159 134 132 162 162 
162 162 132 152 154 153 134 134 134 134 134 134 134 134 134 134 134 134 134 134 134 159 159 159 159 134 134 141 134 134 134 134 134 134 134 134 134 134 134 163 164 165 166 167 134 134 134 132 162 162 
162 162 132 151 150 149 134 141 134 134 134 134 134 132 132 132 132 132 132 160 141 141 141 134 134 134 134 134 134 134 141 132 132 132 132 132 160 134 141 168 169 170 171 172 134 134 141 132 162 162 
162 162 132 147 146 145 144 141 134 134 134 134 134 132 162 162 162 162 132 134 141 134 134 134 134 134 134 163 164 163 164 132 162 162 162 132 134 134 134 173 174 175 176 177 134 134 134 132 162 162 
162 162 132 134 143 142 134 134 134 134 134 134 134 132 162 162 162 162 132 134 141 134 134 134 141 134 134 168 169 168 169 132 162 162 162 132 141 134 134 134 134 134 134 134 141 134 134 132 162 162 
162 162 132 132 132 132 132 132 134 134 132 132 132 132 162 162 162 162 132 132 132 132 132 132 134 134 132 132 132 132 132 132 162 162 162 132 132 132 132 132 132 132 132 132 132 132 132 132 162 162 
162 162 162 162 162 162 162 132 134 134 132 162 162 162 162 162 162 162 162 162 162 162 162 132 141 134 132 162 162 162 162 162 162 162 162 162 162 162 162 162 162 162 162 162 162 162 162 162 162 162 
162 162 162 162 162 162 162 132 134 134 132 162 162 162 162 162 162 162 162 162 162 162 162 132 141 141 132 162 162 162 162 162 162 162 162 162 162 162 162 162 162 162 162 162 162 162 162 162 162 162 
162 162 162 162 162 162 162 132 134 134 132 162 162 162 162 162 162 162 162 162 162 162 162 132 134 141 132 162 162 162 162 162 162 162 162 162 162 162 162 162 162 162 162 162 162 162 162 162 162 162 
162 162 162 162 162 162 162 132 134 134 132 162 162 162 162 162 162 162 162 162 162 162 162 132 134 134 132 162 162 162 162 162 162 162 162 162 162 162 162 162 162 162 162 162 162 162 162 162 162 162 
162 162 162 162 162 162 162 132 134 134 132 162 162 162 162 162 162 162 162 162 162 162 162 132 134 134 132 162 162 162 162 132 132 132 132 132 132 132 132 132 132 132 132 132 132 132 162 162 162 162 
162 162 162 132 132 132 132 132 134 134 132 132 132 132 132 132 132 132 132 162 162 162 162 132 134 134 132 162 162 162 162 132 134 134 134 134 134 134 134 134 134 134 134 134 134 132 162 162 162 162 
162 162 162 132 134 134 134 160 134 134 160 134 134 134 134 134 134 134 132 162 162 162 162 132 134 134 132 162 162 162 162 132 134 134 134 134 134 159 159 159 134 134 134 134 134 132 162 162 162 162 
162 162 162 132 134 134 134 134 134 134 134 134 134 134 134 155 134 160 132 132 132 132 132 132 134 134 132 132 132 132 132 132 160 134 134 134 134 159 159 159 134 134 134 134 134 132 162 162 162 162 
162 162 162 132 134 134 134 134 134 134 134 134 155 178 179 155 134 134 134 134 134 134 134 134 134 134 134 134 134 134 134 134 134 134 134 134 134 159 159 159 134 134 134 134 134 132 162 162 162 162 
162 162 162 132 134 134 159 134 134 134 134 178 179 134 134 134 134 134 134 134 134 134 134 134 134 134 134 134 134 134 134 134 134 134 134 134 134 134 134 134 134 134 134 134 134 132 162 162 162 162 
162 162 162 132 134 134 159 134 134 134 134 134 155 134 155 134 134 160 132 132 132 132 132 132 132 132 132 132 132 132 132 132 160 134 134 134 134 134 134 134 134 134 165 166 167 132 162 162 162 162 
162 162 162 132 134 134 159 159 159 159 134 134 134 134 134 134 134 134 132 162 162 162 162 162 162 162 162 162 162 162 162 132 134 134 134 134 134 134 134 134 134 134 170 171 172 132 162 162 162 162 
162 162 162 132 134 134 134 134 134 134 134 134 134 134 134 134 134 134 132 162 162 162 162 162 162 162 162 162 162 162 162 132 134 134 134 134 134 134 134 134 134 134 175 176 177 132 162 162 162 162 
162 162 162 132 132 132 132 132 132 132 132 132 132 132 132 132 132 132 132 162 162 162 162 162 162 162 162 162 162 162 162 132 132 132 132 132 132 132 132 132 132 132 132 132 132 132 162 162 162 162 
162 162 162 162 162 162 162 162 162 162 162 162 162 162 162 162 162 162 162 162 162 162 162 162 162 162 162 162 162 162 162 162 162 162 162 162 162 162 162 162 162 162 162 162 162 162 162 162 162 162 
162 162 162 162 162 162 162 162 162 162 162 162 162 162 162 162 162 162 162 162 162 162 162 162 162 162 162 162 162 162 162 162 162 162 162 162 162 162 162 162 162 162 162 162 162 162 162 162 162 162 
162 162 162 162 162 162 162 162 162 162 162 162 162 162 162 162 162 162 162 162 162 162 162 162 162 162 162 162 162 162 162 162 162 162 162 162 162 162 162 162 162 162 162 162 162 162 162 162 162 162 
162 162 162 162 162 162 162 162 162 162 162 162 162 162 162 162 162 162 162 162 162 162 162 162 162 162 162 162 162 162 162 162 162 162 162 162 162 162 162 162 162 162 162 162 162 162 162 162 162 162
162 162 162 162 162 162 162 162 162 162 162 162 162 162 162 162 162 162 132 132 132 132 132 132 132 132 132 132 132 132 132 162 162 162 162 162 162 162 162 162 162 162 162 162 162 162 162 162 162 162 
162 162 162 162 162 162 162 162 162 162 162 162 162 162 162 162 162 162 132 134 160 141 134 160 132 135 136 132 160 134 132 162 162 162 162 162 162 162 162 162 162 162 162 162 162 162 162 162 162 162 
162 162 162 162 162 162 162 162 162 162 162 162 162 162 162 162 162 162 132 134 134 134 134 160 132 137 138 132 160 134 132 162 162 162 162 162 162 162 162 162 162 162 162 162 162 162 162 162 162 162 
162 162 162 162 162 162 162 162 162 162 162 162 162 162 162 162 162 162 132 134 134 134 141 134 134 134 134 134 134 134 132 162 162 162 162 162 162 162 162 162 162 162 162 162 162 162 162 162 162 162 
162 162 162 162 162 162 162 162 162 162 162 162 162 162 162 162 162 162 132 134 160 160 160 160 134 134 134 134 134 134 132 162 162 162 162 162 162 162 162 162 162 162 162 162 162 162 162 162 162 162 
162 162 162 162 162 162 162 162 162 162 162 162 162 162 162 162 162 162 132 160 160 135 136 160 160 134 134 134 134 134 132 162 162 162 162 162 162 162 162 162 162 162 162 162 162 162 162 162 162 162 
162 162 162 162 162 162 162 162 162 162 162 162 162 162 162 162 162 162 132 134 134 137 138 134 134 134 134 134 134 134 132 162 162 162 162 162 162 162 162 162 162 162 162 162 162 162 162 162 162 162 
162 162 162 162 162 162 162 162 162 162 162 162 162 162 162 162 162 162 132 160 160 139 140 160 160 134 134 134 134 134 132 162 162 162 162 162 162 162 162 162 162 162 162 162 162 162 162 162 162 162 
162 162 162 162 162 162 162 162 162 162 162 162 162 162 162 162 162 162 132 134 160 160 160 160 134 134 134 134 134 134 132 162 162 162 162 162 162 162 162 162 162 162 162 162 162 162 162 162 162 162 
162 162 162 162 162 162 162 162 162 162 162 162 162 162 162 162 162 162 132 132 132 132 132 132 132 132 132 132 132 132 132 162 162 162 162 162 162 162 162 162 162 162 162 162 162 162 162 162 162 162 
162 162 162 162 162 162 162 162 162 162 162 162 162 162 162 162 162 162 162 162 162 162 162 162 162 162 162 162 162 162 162 162 162 162 162 162 162 162 162 162 162 162 162 162 162 162 162 162 162 162 
162 162 162 162 162 162 162 162 162 162 162 162 162 162 162 162 162 162 162 162 162 162 162 162 162 162 162 162 162 162 162 162 162 162 162 162 162 162 162 162 162 162 162 162 162 162 162 162 162 162
