38 38 38 38 38 38 38 38 38 38 38 38 38 38 38 38 38 38 126 124 124 124 124 124 124 124 124 124 124 124 124 124 124 126 38 38 38 38 38 38 38 38 38 38 38 38 38 38 38 38 
38 38 38 38 38 38 38 38 38 38 38 38 38 38 38 38 38 126 124 126 126 126 126 126 126 126 126 126 126 126 126 126 126 124 126 38 38 38 38 38 38 38 38 38 38 38 38 38 38 38 
38 38 38 38 38 38 38 38 38 38 38 38 38 38 38 38 126 124 126 125 125 125 43 41 41 41 41 41 41 45 125 125 125 126 124 126 38 38 38 38 38 38 38 38 38 38 38 38 38 38 
38 38 38 38 38 38 38 38 38 38 38 38 38 38 38 126 124 126 125 126 126 43 53 54 55 56 51 51 51 48 45 126 126 125 126 124 126 38 38 38 38 38 38 38 38 38 38 38 38 38 
38 38 38 38 38 38 38 38 38 38 38 38 38 38 38 126 124 126 125 126 43 49 62 63 64 65 66 67 68 51 48 45 126 125 126 124 126 38 38 38 38 38 38 38 38 38 38 38 38 38 
38 38 38 38 38 38 38 38 38 38 38 38 38 38 38 126 124 126 125 43 49 70 71 72 73 74 75 76 77 78 51 48 45 125 126 124 126 38 38 38 38 38 38 38 38 38 38 38 38 38 
38 38 38 38 38 38 38 38 38 38 38 38 38 38 38 126 124 126 125 39 51 79 80 81 82 83 84 85 86 87 51 51 40 125 126 124 126 38 38 38 38 38 38 38 38 38 38 38 38 38 
38 38 38 38 38 38 38 38 38 38 38 38 38 38 38 126 124 126 125 39 51 89 90 91 92 93 94 94 95 96 51 51 40 125 126 124 126 38 38 38 38 38 38 38 38 38 38 38 38 38 
38 38 38 38 38 38 38 38 38 38 38 38 38 38 38 126 124 126 125 39 51 51 98 99 100 101 102 103 104 51 51 51 40 125 126 124 126 38 38 38 38 38 38 38 38 38 38 38 38 38 
38 38 38 38 38 38 38 38 38 38 38 38 38 38 38 126 124 126 125 46 51 51 107 108 109 110 111 112 113 51 51 47 44 125 126 124 126 38 38 38 38 38 38 38 38 38 38 38 38 38 
38 38 38 38 38 38 38 38 38 38 38 38 38 38 38 126 124 126 125 127 126 42 116 117 118 119 120 121 51 51 42 44 127 125 126 124 126 38 38 38 38 38 38 38 38 38 38 38 38 38 
38 38 38 38 38 38 38 38 38 38 38 38 38 38 38 126 124 126 125 126 127 126 46 51 51 51 51 51 51 44 126 127 126 125 126 124 126 38 38 38 38 38 38 38 38 38 38 38 38 38 
38 38 38 38 38 38 38 38 38 38 38 38 38 38 38 38 126 124 126 125 126 127 126 126 46 50 47 44 126 126 127 126 125 126 124 126 38 38 38 38 38 38 38 38 38 38 38 38 38 38 
38 38 38 38 127 127 127 127 127 127 127 127 127 127 38 38 38 126 124 126 125 126 127 126 126 39 40 126 126 127 126 125 126 124 126 38 38 38 124 124 124 124 124 124 124 124 124 38 38 38 
38 38 38 127 127 127 127 127 127 127 127 127 127 127 127 38 38 38 126 124 126 125 126 127 126 39 40 126 127 126 125 126 124 126 38 38 38 124 124 124 124 124 124 124 124 124 124 124 38 38 
38 38 127 127 127 127 126 126 126 126 126 126 126 127 127 127 38 38 38 126 124 126 125 126 127 39 40 127 126 125 126 124 126 38 38 38 124 124 124 126 126 126 126 126 126 126 124 124 124 38 
38 38 127 127 127 126 126 127 126 127 126 127 126 126 127 127 127 38 38 38 126 124 126 125 126 39 40 126 125 126 124 126 38 38 38 124 124 124 126 126 126 124 126 124 126 126 126 124 124 124 
38 38 127 127 126 126 126 43 41 41 41 45 126 126 126 127 127 127 38 38 38 126 124 126 125 39 40 125 126 124 126 38 38 38 124 124 124 126 126 124 43 41 41 41 45 124 126 126 124 124 
38 38 127 126 126 127 43 51 51 51 51 48 45 127 126 126 127 127 127 38 38 38 126 124 126 39 40 126 124 126 38 38 38 124 124 124 126 126 126 43 49 51 51 51 48 45 126 126 126 124 
38 38 127 126 126 126 39 51 51 51 51 51 40 126 126 126 126 127 127 127 38 38 38 126 124 39 40 124 126 38 38 38 124 124 124 126 126 126 124 39 51 51 51 51 51 40 124 126 126 124 
38 38 127 126 127 43 49 51 51 51 51 51 48 45 127 126 126 126 127 127 127 38 38 38 126 39 40 126 38 38 38 124 124 124 126 126 126 126 43 49 51 51 51 51 51 48 45 126 126 124 
38 38 127 126 126 39 51 51 51 51 51 51 51 40 126 126 126 126 126 127 127 127 38 38 43 49 48 45 38 38 124 124 124 126 126 126 126 124 39 51 51 51 51 51 51 51 40 124 126 124 
38 38 127 127 43 49 51 51 51 51 51 51 51 48 45 127 126 127 126 126 127 127 127 43 49 51 51 48 45 124 124 124 126 124 126 124 126 43 49 51 51 51 51 51 51 51 48 45 126 124 
38 38 127 126 39 51 51 51 51 51 51 51 51 51 48 41 41 41 41 41 41 41 41 49 51 51 51 51 48 41 41 41 41 41 41 41 41 49 51 51 51 51 51 51 51 51 51 40 125 124 
38 38 127 125 39 51 51 51 51 51 51 51 51 51 47 42 42 42 42 42 42 42 42 50 51 51 51 51 47 42 42 42 42 42 42 42 42 50 51 51 51 51 51 51 51 51 51 40 125 124 
38 38 127 127 46 50 51 51 51 51 51 51 51 47 44 127 125 127 125 125 127 127 127 46 50 51 51 51 44 124 124 124 125 124 125 124 125 46 50 51 51 51 51 51 51 51 51 44 125 124 
38 38 127 125 125 39 51 51 51 51 51 51 51 40 125 125 125 125 125 127 127 127 38 38 46 50 47 44 38 38 124 124 124 125 125 125 125 124 39 51 51 51 51 51 51 51 40 124 125 124 
38 38 127 125 127 46 50 51 51 51 51 51 47 44 127 125 125 125 127 127 127 38 38 38 125 39 40 125 38 38 38 124 124 124 125 125 125 125 46 50 51 51 51 51 51 47 44 125 125 124 
38 38 127 125 125 125 39 51 51 51 51 51 40 125 125 125 125 127 127 127 38 38 38 125 125 39 40 125 125 38 38 38 124 124 124 125 125 125 124 39 51 51 51 51 51 40 124 125 125 124 
38 38 127 125 125 127 46 50 51 51 51 47 44 127 125 125 127 127 127 38 38 38 125 125 125 39 40 125 125 125 38 38 38 124 124 124 125 125 125 46 50 51 51 51 47 44 125 125 125 124 
38 38 127 127 125 125 125 46 42 42 42 44 125 125 125 127 127 127 38 38 38 125 125 125 127 39 40 124 125 125 125 38 38 38 124 124 124 125 125 124 46 42 42 42 44 124 125 125 124 124 
38 38 127 127 127 125 125 127 125 127 125 127 125 125 127 127 127 38 38 38 125 125 125 127 127 39 40 124 124 125 125 125 38 38 38 124 124 124 125 125 125 124 125 124 125 125 125 124 124 124 
38 38 127 127 127 127 125 125 125 125 125 125 125 127 127 127 38 38 38 125 125 125 127 127 125 39 40 125 124 124 125 125 125 38 38 38 124 124 124 125 125 125 125 125 125 125 124 124 124 38 
38 38 38 127 127 127 127 127 127 127 127 127 127 127 127 38 38 38 125 125 125 127 127 127 127 39 40 124 124 124 124 125 125 125 38 38 38 124 124 124 124 124 124 124 124 124 124 124 38 38 
38 38 38 38 127 127 127 127 127 127 127 127 127 127 38 38 38 125 125 125 127 127 127 127 125 39 40 125 124 124 124 124 125 125 125 38 38 38 124 124 124 124 124 124 124 124 124 38 38 38 
38 38 38 38 38 38 38 38 38 38 38 38 38 38 38 38 125 125 125 127 127 127 125 127 43 49 48 45 124 125 124 124 124 125 125 125 38 38 38 38 38 38 38 38 38 38 38 38 38 38 
38 38 38 38 38 38 38 38 38 38 38 38 38 38 38 125 125 125 127 127 125 127 43 41 49 51 51 48 41 45 124 124 124 124 125 125 125 38 38 38 38 38 38 38 38 38 38 38 38 38 
38 38 38 38 38 38 38 38 38 38 38 38 38 38 38 125 125 127 127 127 43 41 49 51 51 51 51 51 51 48 41 125 124 124 124 125 125 38 38 38 38 38 38 38 38 38 38 38 38 38 
38 38 38 38 38 38 38 38 38 38 38 38 38 38 38 125 125 127 125 43 49 51 51 51 51 51 51 51 51 51 51 48 45 124 124 125 125 38 38 38 38 38 38 38 38 38 38 38 38 38 
38 38 38 38 38 38 38 38 38 38 38 38 38 38 38 125 125 127 127 39 51 51 51 51 51 51 51 51 51 51 51 51 40 125 124 125 125 38 38 38 38 38 38 38 38 38 38 38 38 38 
38 38 38 38 38 38 38 38 38 38 38 38 38 38 38 125 125 127 125 39 51 51 51 51 51 51 51 51 51 51 51 51 40 124 124 125 125 38 38 38 38 38 38 38 38 38 38 38 38 38 
38 38 38 38 38 38 38 38 38 38 38 38 38 38 38 125 125 127 127 39 51 51 51 51 51 51 51 51 51 51 51 51 40 125 124 125 125 38 38 38 38 38 38 38 38 38 38 38 38 38 
38 38 38 38 38 38 38 38 38 38 38 38 38 38 38 125 125 127 125 46 50 51 51 51 51 51 51 51 51 51 51 51 44 124 124 125 125 38 38 38 38 38 38 38 38 38 38 38 38 38 
38 38 38 38 38 38 38 38 38 38 38 38 38 38 38 125 125 127 127 127 46 42 50 51 51 51 51 51 51 47 42 44 125 124 124 125 125 38 38 38 38 38 38 38 38 38 38 38 38 38 
38 38 38 38 38 38 38 38 38 38 38 38 38 38 38 125 125 127 127 127 125 127 46 42 50 51 51 47 42 44 125 124 124 124 125 125 125 38 38 38 38 38 38 38 38 38 38 38 38 38 
38 38 38 38 38 38 38 38 38 38 38 38 38 38 38 125 125 125 127 127 127 127 125 127 46 42 42 44 125 124 124 124 124 125 125 125 125 38 38 38 38 38 38 38 38 38 38 38 38 38 
38 38 38 38 38 38 38 38 38 38 38 38 38 38 38 38 125 125 125 127 127 127 127 127 125 127 125 124 124 124 124 124 125 125 125 125 38 38 38 38 38 38 38 38 38 38 38 38 38 38 
38 38 38 38 38 38 38 38 38 38 38 38 38 38 38 38 38 125 125 125 125 125 125 125 125 125 125 125 125 125 125 125 125 125 125 38 38 38 38 38 38 38 38 38 38 38 38 38 38 38 
38 38 38 38 38 38 38 38 38 38 38 38 38 38 38 38 38 38 38 38 38 38 38 38 38 38 38 38 38 38 38 38 38 38 38 38 38 38 38 38 38 38 38 38 38 38 38 38 38 38 
38 38 38 38 38 38 38 38 38 38 38 38 38 38 38 38 38 38 38 38 38 38 38 38 38 38 38 38 38 38 38 38 38 38 38 38 38 38 38 38 38 38 38 38 38 38 38 38 38 0
