187 187 187 187 187 187 187 187 187 187 187 187 187 187 187 187 187 187 187 187 187 187 187 187 187 187 187 187 187 187 187 187 187 187 187 187 187 187 187 187 187 187 187 187 187 187 187 187 187 187 
187 187 187 187 187 187 187 187 187 187 187 187 187 187 187 187 187 187 187 187 187 187 187 187 187 187 187 187 187 187 187 187 187 187 187 187 187 187 187 187 187 187 187 187 187 187 187 187 187 187 
187 187 187 187 187 187 187 187 187 187 187 187 187 187 187 187 187 187 187 187 187 187 187 187 187 187 187 187 187 187 187 187 187 187 187 187 187 187 187 187 187 187 187 187 187 187 187 187 187 187 
187 187 187 187 187 187 187 187 187 187 187 187 187 187 187 187 187 187 187 187 187 187 187 187 187 187 187 187 187 187 187 187 187 187 187 187 187 187 187 187 187 187 187 187 187 187 187 187 187 187 
187 187 187 187 187 187 187 187 187 187 187 187 187 187 187 187 187 187 187 187 187 187 180 180 180 180 187 187 187 187 187 187 187 187 187 187 187 187 187 187 187 187 187 187 187 187 187 187 187 187 
187 187 187 187 187 187 187 187 187 187 187 187 187 187 187 187 187 187 187 187 187 180 183 183 183 036 180 187 187 187 187 187 187 187 187 187 187 187 187 187 187 187 187 187 187 187 187 187 187 187 
187 187 187 187 187 187 187 187 187 187 187 187 187 187 187 187 187 187 187 187 180 182 182 182 182 182 183 180 187 187 187 187 187 187 187 187 187 187 187 187 187 187 187 187 187 187 187 187 187 187 
187 187 187 187 187 187 187 187 187 187 187 187 187 187 187 187 187 187 187 180 189 182 182 182 182 182 183 189 180 187 187 187 187 187 187 187 187 187 187 187 187 187 187 187 187 187 187 187 187 187 
187 187 187 187 187 187 187 187 187 187 180 180 180 180 180 180 180 180 180 186 190 182 182 182 182 182 183 190 186 180 180 180 180 180 180 180 180 180 180 180 187 187 187 187 187 187 187 187 187 187 
187 187 187 187 187 187 187 187 187 187 180 182 182 182 182 182 182 182 182 182 182 182 333 334 334 182 182 183 182 183 183 183 183 183 183 183 183 183 183 180 187 187 187 187 187 187 187 187 187 187 
187 187 187 187 187 187 187 187 187 187 180 182 182 182 182 182 182 182 182 182 182 182 337 337 339 182 182 183 182 182 182 182 182 182 182 182 182 182 183 180 187 187 187 187 187 187 187 187 187 187 
187 187 187 187 187 187 187 187 187 187 180 182 182 180 180 180 180 180 180 186 189 182 182 182 182 182 182 189 186 180 180 180 180 180 180 180 180 182 183 180 187 187 187 187 187 187 187 187 187 187 
187 187 187 187 187 187 187 187 187 187 180 182 182 180 187 187 187 187 187 180 190 182 182 182 182 182 183 190 180 187 187 187 187 187 187 187 180 182 183 180 187 187 187 187 187 187 187 187 187 187 
187 187 187 187 187 187 187 187 187 187 180 182 182 180 187 187 187 187 187 187 180 182 182 182 182 183 183 180 187 187 187 187 187 187 187 187 180 182 183 180 187 187 187 187 187 187 187 187 187 187 
187 187 187 187 187 187 187 187 187 187 180 182 182 180 187 187 187 187 187 187 187 180 182 182 183 183 180 187 187 187 187 187 187 187 187 187 180 182 183 180 187 187 187 187 187 187 187 187 187 187 
187 187 187 187 187 187 187 187 187 187 180 182 182 180 187 187 187 187 187 187 187 187 180 180 180 180 187 187 187 187 187 187 187 187 187 187 180 182 183 180 187 187 187 187 187 187 187 187 187 187 
187 187 187 187 187 187 187 187 187 187 180 182 182 180 187 187 187 187 187 187 187 187 187 187 187 187 187 187 187 187 187 187 187 187 187 187 180 182 183 180 187 187 187 187 187 187 187 187 187 187 
187 187 187 187 187 187 187 187 187 187 180 182 182 180 187 187 187 187 187 187 187 187 187 187 187 187 187 187 187 187 187 187 187 187 187 187 180 182 183 180 187 187 187 187 187 187 187 187 187 187 
187 187 187 187 187 187 187 187 187 187 180 182 182 180 187 187 187 187 187 187 187 187 187 187 187 187 187 187 187 187 187 187 187 187 187 187 180 182 183 180 187 187 187 187 187 187 187 187 187 187 
187 187 187 187 187 187 187 187 187 187 180 182 182 180 187 187 187 187 187 187 187 187 187 187 187 187 187 187 187 187 187 187 187 187 187 187 180 182 183 180 187 187 187 187 187 187 187 187 187 187 
187 187 187 187 187 187 187 187 180 180 186 182 182 186 180 180 187 187 187 187 187 187 187 187 187 187 187 187 187 187 187 187 187 187 180 180 186 182 183 186 180 180 187 187 187 187 187 187 187 187 
187 187 187 187 187 187 187 180 182 189 183 183 183 183 189 183 180 187 187 187 187 187 187 187 187 187 187 187 187 187 187 187 187 180 182 183 183 183 183 183 183 183 180 187 187 187 187 187 187 187 
187 187 187 187 187 187 180 182 182 190 182 182 182 182 190 183 183 180 187 187 187 187 187 187 187 187 187 187 187 187 187 187 180 182 182 182 182 182 182 182 183 183 183 180 187 187 187 187 187 187 
187 187 187 187 187 180 182 182 182 182 182 182 182 182 182 182 183 183 180 187 187 187 187 187 187 187 187 187 187 187 187 180 182 182 182 182 182 182 182 182 182 182 182 183 180 187 187 187 187 187 
187 187 187 187 180 182 182 182 182 182 182 182 182 182 184 182 184 182 183 180 187 187 187 187 187 187 187 187 187 187 180 182 182 182 188 182 182 182 182 182 188 182 182 183 188 180 187 187 187 187 
187 187 187 180 182 182 182 182 301 302 303 304 182 182 182 184 182 182 183 189 180 187 187 187 187 187 187 187 187 180 182 182 182 182 182 191 192 193 194 194 182 196 182 182 188 183 180 187 187 187 
187 187 187 180 182 183 183 182 305 306 307 308 182 182 182 182 182 182 182 190 186 180 180 180 180 180 180 180 180 186 182 182 182 182 188 197 198 199 200 201 202 182 182 182 188 183 180 187 187 187 
187 187 187 180 182 183 183 182 309 310 311 312 182 182 184 184 182 182 182 182 182 182 182 182 182 182 182 182 182 182 182 182 182 182 188 203 204 205 206 207 182 182 182 188 188 183 180 187 187 187 
187 187 187 180 182 183 183 182 313 314 315 316 182 182 184 184 182 182 182 182 183 183 183 183 183 182 182 182 182 182 182 182 182 182 182 209 210 211 212 213 214 182 182 182 182 183 180 187 187 187 
187 187 187 180 182 183 183 182 317 318 319 320 182 182 184 183 182 182 182 189 186 180 180 180 183 182 180 180 180 186 183 182 182 182 182 215 216 217 218 219 220 182 182 182 188 183 180 187 187 187 
187 187 187 180 182 183 183 182 321 322 323 324 182 182 184 183 182 182 182 190 180 187 187 180 183 182 180 187 187 180 183 182 182 188 182 182 182 182 182 182 182 182 182 188 188 183 180 187 187 187 
187 187 187 187 180 182 182 182 325 326 327 328 182 182 182 182 182 183 183 180 187 187 187 180 183 182 180 187 187 187 180 182 182 188 188 182 182 188 188 182 182 182 188 183 183 180 187 187 187 187 
187 187 187 187 187 180 182 182 182 182 182 182 182 182 182 182 183 183 180 187 187 187 187 180 183 182 180 187 187 187 187 180 182 182 182 182 182 188 188 182 182 182 182 183 180 187 187 187 187 187 
187 187 187 187 187 187 180 182 182 189 182 182 182 182 189 183 183 180 187 187 187 187 187 180 183 182 180 187 187 187 187 187 180 182 182 183 182 182 182 182 182 182 183 180 187 187 187 187 187 187 
187 187 187 187 187 187 187 180 182 190 182 182 182 182 190 183 180 187 187 187 187 187 187 180 183 182 180 187 187 187 187 187 187 180 182 182 183 183 183 183 183 183 180 187 187 187 187 187 187 187 
187 187 187 187 187 187 187 187 180 180 186 182 182 186 180 180 187 187 187 187 187 187 187 180 183 182 180 187 187 187 187 187 187 187 180 180 186 182 182 186 180 180 187 187 187 187 187 187 187 187 
187 187 187 187 187 187 187 187 187 187 180 186 182 180 187 187 187 187 187 187 187 187 187 180 183 182 180 187 187 187 187 187 187 187 187 187 180 182 182 180 187 187 187 187 187 187 187 187 187 187 
187 187 187 187 187 187 187 187 187 187 180 182 182 180 187 187 187 187 187 187 187 187 187 180 183 182 180 187 187 187 187 187 187 187 187 187 180 182 182 180 187 187 187 187 187 187 187 187 187 187 
187 187 187 187 187 187 187 187 187 187 180 182 186 180 187 187 187 187 187 187 187 187 187 180 183 182 180 187 187 187 187 187 187 180 180 180 186 182 182 186 180 180 180 180 180 180 187 187 187 187 
187 187 187 187 187 187 187 187 187 180 186 182 182 186 180 187 187 187 187 187 187 187 187 180 183 182 180 187 187 187 187 187 180 182 182 183 183 183 183 183 183 183 183 183 183 183 180 187 187 187 
187 187 187 187 187 187 187 187 180 189 183 186 183 183 189 180 187 187 187 187 187 187 187 180 183 182 180 187 187 187 187 180 189 182 182 182 182 182 182 182 182 182 182 183 182 183 183 180 187 187 
187 187 187 187 187 187 187 180 183 190 182 182 182 182 190 182 180 187 187 187 187 187 187 180 183 182 180 180 180 180 180 186 190 182 182 183 183 183 183 182 183 183 183 183 182 182 183 180 187 187 
187 187 187 187 187 187 180 183 182 182 182 182 182 182 182 182 182 180 187 187 187 187 187 180 183 183 182 182 182 182 182 182 183 182 233 182 182 183 183 183 183 183 183 183 182 244 183 180 187 187 
187 187 187 187 187 187 180 183 182 182 184 184 184 184 182 182 182 180 187 187 187 187 187 180 183 183 183 183 183 183 183 183 183 182 245 182 182 251 182 250 251 182 182 254 255 256 183 180 187 187 
187 187 187 187 187 187 180 183 183 182 184 162 162 184 182 182 182 180 187 187 187 187 187 180 180 180 180 180 180 180 180 186 189 182 257 258 259 182 182 262 263 182 182 266 267 268 183 180 187 187 
187 187 187 187 187 187 187 180 183 183 184 162 162 184 182 182 180 187 187 187 187 187 187 187 187 187 187 187 187 187 187 180 190 182 269 270 271 272 273 274 275 276 277 278 279 280 183 180 187 187 
187 187 187 187 187 187 187 187 180 183 184 162 162 184 182 180 187 187 187 187 187 187 187 187 187 187 187 187 187 187 187 187 180 182 281 282 283 284 285 286 287 288 289 289 291 292 180 187 187 187 
187 187 187 187 187 187 187 187 187 180 180 180 180 180 180 187 187 187 187 187 187 187 187 187 187 187 187 187 187 187 187 187 187 180 180 180 180 180 180 180 180 180 180 180 180 180 187 187 187 187 
187 187 187 187 187 187 187 187 187 187 187 187 187 187 187 187 187 187 187 187 187 187 187 187 187 187 187 187 187 187 187 187 187 187 187 187 187 187 187 187 187 187 187 187 187 187 187 187 187 187 
187 187 187 187 187 187 187 187 187 187 187 187 187 187 187 187 187 187 187 187 187 187 187 187 187 187 187 187 187 187 187 187 187 187 187 187 187 187 187 187 187 187 187 187 187 187 187 187 187 187
